# # # # # # # # # # # # #
# - - - - - - - - - - - #
# - - * - - - - - * - - #
# - - - - - - - - - - - #
# - - * - - - - - * - - #
# - - - - - - - - - - - #
# # # # # # D # # # # # #