# # # # # # # # # # # # #
# - - - - - - - - - - - #
# - - * - - - - - * - - #
# - - - - - - - - - - - D
# - - * - - - - - * - - #
# - - - - - - - - - - - #
# # # # # # # # # # # # #