# # # # # # D # # # # # #
# - - - - - - - - - - - #
# - - * - - - - - * - - #
D - - - - - - - - - - - #
# - - * - - - - - * - - #
# - - - - - - - - - - - #
# # # # # # # # # # # # #