# # # # # # D # # # # # #
# - - - - - - - - - - - #
# - - * - - - - - * - - #
# - - - - - - - - - - - D
# - - * - - - - - * - - #
# - - - - - - - - - - - #
# # # # # # D # # # # # #