# # # # # # D # # # # # #
# - - - - - - - - - - - #
# - - * - - - - - * - - #
D - - - - - - - - - - - D
# - - * - - - - - * - - #
# - - - - - - - - - - - #
# # # # # # # # # # # # #